startMessage=So you want to watch YouTube?
vloggerStart=Vlogger
musicianStart=Musician
singleOrColab=Do you want a collab or single channel?
collab=Collab
single=Single
newOrOld=Do you want to watch new videos or two year old videos?
old=Old
new=New
oldAnwser=FIVEAWESOMEGUYS
peopleInRelation=People in relationships make you...
happy=Happy
sick=Sick
happyAnswer=VLOGLOVERS
doctorWho=Are you obsessed with Doctor Who?
absolutely=Absolutely
whatsThat=What's that?
absolutelyAnswer=TARDISTACULAR
howManyPeople=How many people do you want to watch?
five=Five
two=Two
fiveAnswer=FIVEAWESOMEGIRLS
shortOrTall=Do you want to watch short or tall people?
short=Short
tall=Tall
shortAnswer=SHORTSISTERS756
girlsOrBoys=Girls or boys?
girls=Girls
boys=Boys
girlsAnswer=SISTERSALAD
boysAnswer=VLOGBROTHERS
whatAccent=What kind of accent do you like?
british=British
american=American
somethingElse=Something else
isCanadaCool=Canada's cool, right?
yeah=Yeah!
canadaSucks=Canada sucks
yeahAnswer=GUNAROLLA
whichIsFunnier=Which is funnier?
selfDepricatingHumor=Self-depricating humor
jokesAboutChickens=Jokes about chickens
jokesAboutChickensAnswer=ROBOFILLET
selfDepricatingHumorAnswer=COMMUNITYCHANNEL
isTennantAttractive=Do you find David Tennant attractive?
duh=Duh
duhAnswer=LITTLERADGE
areBoysWhoPlayHot=Well then, are boys who play an instrument hot?
no=No
yes=Yes
scriptedOrSpontaneous=Do you prefer scripted or spontaneous videos?
spontaneous=Spontaneous
scripted=Scripted
scriptedAnswer=ELECTRICFAERIEDUST
spontaneousAnswer=MISSXROJAS
isTwilightHated=Do you hate Twilight?
dontCare=Don't care
hatedAnswer=NERIMON
dontCareAnswer=CHARLIEISSOCOOLLIKE
notHatedAnswer=GET OUT OF MY FLOWCHART
singsSometimesOrNever=Someone who sometimes sings or never sings?
sometimesSings=Sometimes sings
neverSings=Never sings
dailyOrNot=Do you want daily videos?
dailyAnswer=BREAKINGNYC
aviceOrNot=Do you need Avice?
yesPlease=Yes, please
yesPleaseAnswer=PERON75
likesSeeingDifferentVersionsOfPeopleOrNot=Do you like seeing people play different versions of themselves?
noThatsWeird=No, that's weird
likesSeeingDifferentVersionsOfPeopleAnswer=ELMIFY
howManySubscribers=How many subscribers do you prefer they have?
lessThan100000=Less than 100,000
moreThan100000=More than 100,000
whatWantToWatchSomeoneDo=Do you want to watch someone...
talkWorldIssues=Talk world issues
talkWorldIssuesAnswer=POGOBAT
rantAndBeAdorable=Rant and be adorable
rantAndBeAdorableAnswer=MEEKAKITTY
putOnMakeUp=Put on make up
putOnMakeUpAnswer=MICHELLEPHAN
isTypographyCool=Typography is cool.
agreed=Agreed.
whatsTypography=What's typography?
agreedAnswer=XPERPETUALMOTION
onlyFiveawesomesOrNot=Do you only watch fiveawesomes?
whoAreThey=Who are they?
girlsOrBoysFiveawesomes=Girls or boys?
girlsFiveawesomesAnswer=OWLSSAYHOOOT
boysFiveawesomesAnswer=ALANVLOGS
youArePicky=You sure are picky.
yup=Yup.
yupAnswer=TRY THATZAK, EVERYONE LIKES HIM
likesRappingOrNot=Do you like rapping?
likesRappingAnswer=HAYLEYGHOOVER
likesBreakfastSongsOrNot=Do you only like songs about breakfast?
ofCourse=Of course
umNo=Um, no
likesBreakfastSongsAnswer=WHEEZYWAITER
likesChartsGraphsOrNot=Do you really like charts and graphs?
yes!=Yes!
notReally=Not really
likesChartsGraphsAnswer=MICKELEH
lovesAllCapsOrNot=DO YOU LOVE ALL CAPS?
yesCaps=YES
notMyStyle=Not my style
girlsOrBoysRule=DO GIRLS OR BOYS RULE?
girls!=GIRLS!
boys!=BOYS!
girlsRuleAnswer=ITALKTOSNAKES
boysRuleAnswer=LUKECONARD
insistsOnFiveawesomegirlOrNot=Do you insist on watching a fiveawesomegirl?
insistsOnFiveawesomegirlAnswer=DEVILISHLYPURE
likesHappyPeopleOrNot=Do you like really, really happy people?
sadFace==(
happyFace==D
likesHappyPeopleAnswer=HOPEONATENSPEED
whenNotSinging=When not singing, you want your vlogger to...
talkFast=Talk fast
talkSlow=Talk slow
talkFastAnswer=FIZZYLIMON
prefersToReview=You prefer your vlogger to review...
technology=Technology
books=Books
technologyAnswer=IJUSTINE
booksAnswer=BANDGEEK8408
wizardOrMuggle=Wizard rocker or muggle musician?
wizard=Wizard
muggle=Muggle
wizardRockIs=Wizard rock is...
awesome=Awesome
kindOfWeird=Kind of weird
kindOfWeirdAnswer=FELTBEATS
livePerformancesOrNot=Do you only want live performances?
livePerformancesAnswer=KARENSWROCKVIDEOS
tooCheapToBuyCdsOrNot=Are you too cheap to buy ministry of magic CDs?
weasley=I'm a Weasley!
malfoy=As a Malfoy, I guess not
weasleyAnswer=MINISTRYOFMAGICMUSIC
isWhompingWillowAwesome=The Whomping Willow is awesome.
true=True
false=False
trueAnswer=THEWHOMPINGWILLOWS
falseAnswer=BUTTERBEERWROCKS
mustExistOrNot=is it necessary that they actually exist?
notNecessaryToExistAnswer=PAIGERAILSTONE
isLostBest=Is lost the best show ever?
notAtAll=Not at all
lostBestAnswer=THEOCEANICSIXMUSIC
likesCouplesOrNot=Do you like it when couples make music?
blech=Blech
likesElectronicaOrNot=Do you like electronica?
likesElectronicaAnswer=ALLCAPSMUSIC
dislikesElectronicaAnswer=POMPLAMOOSEMUSIC
easilyOffendedOrNot=Are you easily offended?
notEasilyOffended=BOBURNHAM
likesUkulelesOrNot=Do you really like ukuleles?
heckYes=Heck yes!
nerdyOrNormal=Do you prefer really nerdy or normal songs?
nerdy=Nerdy
normal=Normal
normalAnswer=JAAAAAAA
nerdyAnswer=SWEETAFTON23
mellowOrRock=Do you want to mellow out or rock out?
mellow=Mellow
rock=Rock
mellowAnswer=SONGSFROMPAUL
strangeOrNormal=Relatively normal or strange lyrics?
strange=Strange
mileyOrRandomness=Which is better - Miley Cyrus or Randomness?
miley=Miley
random=Random
mileyAnswer=DAVEDAYS
randomAnswer=RHETTANDLINK
pianoOrGuitar=Piano Rock or guitar rock?
piano=Piano
guitar=Guitar
pianoAnswer=MIKELOMBARDOMUSIC
guitarAnswer=DOCTORNOISE